shortName	originalName
Barnesiella.[1]	d__Bacteria.p__Bacteroidota.c__Bacteroidia.o__Bacteroidales.f__Barnesiellaceae.g__Barnesiella.__
Bifidobacterium.[2]	d__Bacteria.p__Actinobacteriota.c__Actinobacteria.o__Bifidobacteriales.f__Bifidobacteriaceae.g__Bifidobacterium.__
g__Ruminococcus (UB*)[3]	d__Bacteria.p__Firmicutes.c__Clostridia.o__Oscillospirales.f__Ruminococcaceae.g__Ruminococcus.s__uncultured_bacterium
Streptococcus_salivarius[4]	d__Bacteria.p__Firmicutes.c__Bacilli.o__Lactobacillales.f__Streptococcaceae.g__Streptococcus.s__Streptococcus_salivarius
Blautia.[5]	d__Bacteria.p__Firmicutes.c__Clostridia.o__Lachnospirales.f__Lachnospiraceae.g__Blautia.__
g__Shuttleworthia (UB*)[6]	d__Bacteria.p__Firmicutes.c__Clostridia.o__Lachnospirales.f__Lachnospiraceae.g__Shuttleworthia.s__uncultured_bacterium
g__Clostridia_UCG.014 (UB*)[7]	d__Bacteria.p__Firmicutes.c__Clostridia.o__Clostridia_UCG.014.f__Clostridia_UCG.014.g__Clostridia_UCG.014.s__uncultured_bacterium
g__Holdemanella (UB*)[8]	d__Bacteria.p__Firmicutes.c__Bacilli.o__Erysipelotrichales.f__Erysipelotrichaceae.g__Holdemanella.s__uncultured_bacterium
g__Faecalitalea (UB*)[9]	d__Bacteria.p__Firmicutes.c__Bacilli.o__Erysipelotrichales.f__Erysipelotrichaceae.g__Faecalitalea.s__uncultured_bacterium
g__.Eubacterium._brachy_group (UB*)[10]	d__Bacteria.p__Firmicutes.c__Clostridia.o__Peptostreptococcales.Tissierellales.f__Anaerovoracaceae.g__.Eubacterium._brachy_group.s__uncultured_bacterium
g__.Eubacterium._coprostanoligenes_group (UB*)[11]	d__Bacteria.p__Firmicutes.c__Clostridia.o__Oscillospirales.f__.Eubacterium._coprostanoligenes_group.g__.Eubacterium._coprostanoligenes_group.s__uncultured_bacterium
g__Dialister (UB*)[12]	d__Bacteria.p__Firmicutes.c__Negativicutes.o__Veillonellales.Selenomonadales.f__Veillonellaceae.g__Dialister.s__uncultured_bacterium
g__Erysipelotrichaceae_UCG.003 (UB*)[13]	d__Bacteria.p__Firmicutes.c__Bacilli.o__Erysipelotrichales.f__Erysipelatoclostridiaceae.g__Erysipelotrichaceae_UCG.003.s__uncultured_bacterium
Faecalibacterium.[14]	d__Bacteria.p__Firmicutes.c__Clostridia.o__Oscillospirales.f__Ruminococcaceae.g__Faecalibacterium.__
g__Bacteroides (UB*)[15]	d__Bacteria.p__Bacteroidota.c__Bacteroidia.o__Bacteroidales.f__Bacteroidaceae.g__Bacteroides.s__uncultured_bacterium
Escherichia_coli[16]	d__Bacteria.p__Proteobacteria.c__Gammaproteobacteria.o__Enterobacterales.f__Enterobacteriaceae.g__Escherichia.Shigella.s__Escherichia_coli
Roseburia.[17]	d__Bacteria.p__Firmicutes.c__Clostridia.o__Lachnospirales.f__Lachnospiraceae.g__Roseburia.__
g__Subdoligranulum (UB*)[18]	d__Bacteria.p__Firmicutes.c__Clostridia.o__Oscillospirales.f__Ruminococcaceae.g__Subdoligranulum.s__uncultured_bacterium
g__Roseburia (UB*)[19]	d__Bacteria.p__Firmicutes.c__Clostridia.o__Lachnospirales.f__Lachnospiraceae.g__Roseburia.s__uncultured_bacterium
g__Blautia (UB*)[20]	d__Bacteria.p__Firmicutes.c__Clostridia.o__Lachnospirales.f__Lachnospiraceae.g__Blautia.s__uncultured_bacterium
g__Megasphaera (UB*)[21]	d__Bacteria.p__Firmicutes.c__Negativicutes.o__Veillonellales.Selenomonadales.f__Veillonellaceae.g__Megasphaera.s__uncultured_bacterium
Lachnospiraceae.[22]	d__Bacteria.p__Firmicutes.c__Clostridia.o__Lachnospirales.f__Lachnospiraceae.__.__
g__Akkermansia (UB*)[23]	d__Bacteria.p__Verrucomicrobiota.c__Verrucomicrobiae.o__Verrucomicrobiales.f__Akkermansiaceae.g__Akkermansia.s__uncultured_bacterium
g__Anaerostipes (UB*)[24]	d__Bacteria.p__Firmicutes.c__Clostridia.o__Lachnospirales.f__Lachnospiraceae.g__Anaerostipes.s__uncultured_bacterium
g__Candidatus_Stoquefichus (UB*)[25]	d__Bacteria.p__Firmicutes.c__Bacilli.o__Erysipelotrichales.f__Erysipelatoclostridiaceae.g__Candidatus_Stoquefichus.s__uncultured_bacterium
g__Faecalibacterium (UB*)[26]	d__Bacteria.p__Firmicutes.c__Clostridia.o__Oscillospirales.f__Ruminococcaceae.g__Faecalibacterium.s__uncultured_bacterium
Veillonella.[27]	d__Bacteria.p__Firmicutes.c__Negativicutes.o__Veillonellales.Selenomonadales.f__Veillonellaceae.g__Veillonella.__
g__.Eubacterium._xylanophilum_group (UB*)[28]	d__Bacteria.p__Firmicutes.c__Clostridia.o__Lachnospirales.f__Lachnospiraceae.g__.Eubacterium._xylanophilum_group.s__uncultured_bacterium
Parabacteroides.[29]	d__Bacteria.p__Bacteroidota.c__Bacteroidia.o__Bacteroidales.f__Tannerellaceae.g__Parabacteroides.__
g__Veillonella (UB*)[30]	d__Bacteria.p__Firmicutes.c__Negativicutes.o__Veillonellales.Selenomonadales.f__Veillonellaceae.g__Veillonella.s__uncultured_bacterium
g__Erysipelatoclostridium (UB*)[31]	d__Bacteria.p__Firmicutes.c__Bacilli.o__Erysipelotrichales.f__Erysipelatoclostridiaceae.g__Erysipelatoclostridium.s__uncultured_bacterium
g__Bifidobacterium (UB*)[32]	d__Bacteria.p__Actinobacteriota.c__Actinobacteria.o__Bifidobacteriales.f__Bifidobacteriaceae.g__Bifidobacterium.s__uncultured_bacterium
Streptococcus_sp.[33]	d__Bacteria.p__Firmicutes.c__Bacilli.o__Lactobacillales.f__Streptococcaceae.g__Streptococcus.s__Streptococcus_sp.
g__uncultured (UB*)[34]	d__Bacteria.p__Firmicutes.c__Clostridia.o__Oscillospirales.f__Oscillospiraceae.g__uncultured.s__uncultured_bacterium
g__Catenibacterium (UB*)[35]	d__Bacteria.p__Firmicutes.c__Bacilli.o__Erysipelotrichales.f__Erysipelatoclostridiaceae.g__Catenibacterium.s__uncultured_bacterium
g__Collinsella (UB*)[36]	d__Bacteria.p__Actinobacteriota.c__Coriobacteriia.o__Coriobacteriales.f__Coriobacteriaceae.g__Collinsella.s__uncultured_bacterium
Bacteroides.[37]	d__Bacteria.p__Bacteroidota.c__Bacteroidia.o__Bacteroidales.f__Bacteroidaceae.g__Bacteroides.__
Eubacterium.[38]	d__Bacteria.p__Firmicutes.c__Clostridia.o__Eubacteriales.f__Eubacteriaceae.g__Eubacterium.__
Lachnoclostridium.[39]	d__Bacteria.p__Firmicutes.c__Clostridia.o__Lachnospirales.f__Lachnospiraceae.g__Lachnoclostridium.__
g__Fusicatenibacter (UB*)[40]	d__Bacteria.p__Firmicutes.c__Clostridia.o__Lachnospirales.f__Lachnospiraceae.g__Fusicatenibacter.s__uncultured_bacterium
g__NK4A214_group (UB*)[41]	d__Bacteria.p__Firmicutes.c__Clostridia.o__Oscillospirales.f__Oscillospiraceae.g__NK4A214_group.s__uncultured_bacterium
g__Family_XIII_AD3011_group (UB*)[42]	d__Bacteria.p__Firmicutes.c__Clostridia.o__Peptostreptococcales.Tissierellales.f__Anaerovoracaceae.g__Family_XIII_AD3011_group.s__uncultured_bacterium
g__Christensenellaceae_R.7_group (UB*)[43]	d__Bacteria.p__Firmicutes.c__Clostridia.o__Christensenellales.f__Christensenellaceae.g__Christensenellaceae_R.7_group.s__uncultured_bacterium
Citrobacter.[44]	d__Bacteria.p__Proteobacteria.c__Gammaproteobacteria.o__Enterobacterales.f__Enterobacteriaceae.g__Citrobacter.__
g__Coprococcus (UB*)[45]	d__Bacteria.p__Firmicutes.c__Clostridia.o__Lachnospirales.f__Lachnospiraceae.g__Coprococcus.s__uncultured_bacterium
g__Lachnospira (UB*)[46]	d__Bacteria.p__Firmicutes.c__Clostridia.o__Lachnospirales.f__Lachnospiraceae.g__Lachnospira.s__uncultured_bacterium
g__Flavonifractor (UB*)[47]	d__Bacteria.p__Firmicutes.c__Clostridia.o__Oscillospirales.f__Oscillospiraceae.g__Flavonifractor.s__uncultured_bacterium
g__.Eubacterium._hallii_group (UB*)[48]	d__Bacteria.p__Firmicutes.c__Clostridia.o__Lachnospirales.f__Lachnospiraceae.g__.Eubacterium._hallii_group.s__uncultured_bacterium
g__.Ruminococcus._gauvreauii_group (UB*)[49]	d__Bacteria.p__Firmicutes.c__Clostridia.o__Lachnospirales.f__Lachnospiraceae.g__.Ruminococcus._gauvreauii_group.s__uncultured_bacterium
.Eubacterium._hallii[50]	d__Bacteria.p__Firmicutes.c__Clostridia.o__Lachnospirales.f__Lachnospiraceae.g__.Eubacterium._hallii_group.s__.Eubacterium._hallii
Bifidobacterium_dentium[51]	d__Bacteria.p__Actinobacteriota.c__Actinobacteria.o__Bifidobacteriales.f__Bifidobacteriaceae.g__Bifidobacterium.s__Bifidobacterium_dentium
g__Prevotella (UB*)[52]	d__Bacteria.p__Bacteroidota.c__Bacteroidia.o__Bacteroidales.f__Prevotellaceae.g__Prevotella.s__uncultured_bacterium
g__UCG.002 (UB*)[53]	d__Bacteria.p__Firmicutes.c__Clostridia.o__Oscillospirales.f__Oscillospiraceae.g__UCG.002.s__uncultured_bacterium
Agathobacter.[54]	d__Bacteria.p__Firmicutes.c__Clostridia.o__Lachnospirales.f__Lachnospiraceae.g__Agathobacter.__
g__Agathobacter (UB*)[55]	d__Bacteria.p__Firmicutes.c__Clostridia.o__Lachnospirales.f__Lachnospiraceae.g__Agathobacter.s__uncultured_bacterium
g__UCG.005 (UB*)[56]	d__Bacteria.p__Firmicutes.c__Clostridia.o__Oscillospirales.f__Oscillospiraceae.g__UCG.005.s__uncultured_bacterium
g__Streptococcus (UB*)[57]	d__Bacteria.p__Firmicutes.c__Bacilli.o__Lactobacillales.f__Streptococcaceae.g__Streptococcus.s__uncultured_bacterium
g__Senegalimassilia (UB*)[58]	d__Bacteria.p__Actinobacteriota.c__Coriobacteriia.o__Coriobacteriales.f__Eggerthellaceae.g__Senegalimassilia.s__uncultured_bacterium
uncultured_organism[59]	d__Bacteria.p__Bacteroidota.c__Bacteroidia.o__Bacteroidales.f__Bacteroidaceae.g__Bacteroides.s__uncultured_organism
uncultured_organism[60]	d__Bacteria.p__Firmicutes.c__Clostridia.o__Oscillospirales.f__Ruminococcaceae.g__Faecalibacterium.s__uncultured_organism
g__uncultured (UB*)[61]	d__Bacteria.p__Firmicutes.c__Clostridia.o__Lachnospirales.f__Lachnospiraceae.g__uncultured.s__uncultured_bacterium
g__.Clostridium._innocuum_group (UB*)[62]	d__Bacteria.p__Firmicutes.c__Bacilli.o__Erysipelotrichales.f__Erysipelotrichaceae.g__.Clostridium._innocuum_group.s__uncultured_bacterium
g__.Eubacterium._eligens_group (UB*)[63]	d__Bacteria.p__Firmicutes.c__Clostridia.o__Lachnospirales.f__Lachnospiraceae.g__.Eubacterium._eligens_group.s__uncultured_bacterium
Family_XIII_AD3011_group.[64]	d__Bacteria.p__Firmicutes.c__Clostridia.o__Peptostreptococcales.Tissierellales.f__Anaerovoracaceae.g__Family_XIII_AD3011_group.__
Bifidobacterium_animalis[65]	d__Bacteria.p__Actinobacteriota.c__Actinobacteria.o__Bifidobacteriales.f__Bifidobacteriaceae.g__Bifidobacterium.s__Bifidobacterium_animalis
Clostridium_sensu_stricto_2.[66]	d__Bacteria.p__Firmicutes.c__Clostridia.o__Clostridiales.f__Clostridiaceae.g__Clostridium_sensu_stricto_2.__
g__Phascolarctobacterium (UB*)[67]	d__Bacteria.p__Firmicutes.c__Negativicutes.o__Acidaminococcales.f__Acidaminococcaceae.g__Phascolarctobacterium.s__uncultured_bacterium
Eisenbergiella.[68]	d__Bacteria.p__Firmicutes.c__Clostridia.o__Lachnospirales.f__Lachnospiraceae.g__Eisenbergiella.__
Methanobrevibacter.[69]	d__Archaea.p__Euryarchaeota.c__Methanobacteria.o__Methanobacteriales.f__Methanobacteriaceae.g__Methanobrevibacter.__
g__Turicibacter (UB*)[70]	d__Bacteria.p__Firmicutes.c__Bacilli.o__Erysipelotrichales.f__Erysipelotrichaceae.g__Turicibacter.s__uncultured_bacterium
g__Monoglobus (UB*)[71]	d__Bacteria.p__Firmicutes.c__Clostridia.o__Monoglobales.f__Monoglobaceae.g__Monoglobus.s__uncultured_bacterium
g__.Ruminococcus._torques_group (UB*)[72]	d__Bacteria.p__Firmicutes.c__Clostridia.o__Lachnospirales.f__Lachnospiraceae.g__.Ruminococcus._torques_group.s__uncultured_bacterium
Alistipes.[73]	d__Bacteria.p__Bacteroidota.c__Bacteroidia.o__Bacteroidales.f__Rikenellaceae.g__Alistipes.__
Megasphaera.[74]	d__Bacteria.p__Firmicutes.c__Negativicutes.o__Veillonellales.Selenomonadales.f__Veillonellaceae.g__Megasphaera.__
g__Enterorhabdus (UB*)[75]	d__Bacteria.p__Actinobacteriota.c__Coriobacteriia.o__Coriobacteriales.f__Eggerthellaceae.g__Enterorhabdus.s__uncultured_bacterium
g__Incertae_Sedis (UB*)[76]	d__Bacteria.p__Firmicutes.c__Clostridia.o__Oscillospirales.f__Ruminococcaceae.g__Incertae_Sedis.s__uncultured_bacterium
Erysipelatoclostridium.[77]	d__Bacteria.p__Firmicutes.c__Bacilli.o__Erysipelotrichales.f__Erysipelatoclostridiaceae.g__Erysipelatoclostridium.__
Anaerosporobacter.[78]	d__Bacteria.p__Firmicutes.c__Clostridia.o__Lachnospirales.f__Lachnospiraceae.g__Anaerosporobacter.__
g__Lachnospiraceae_NK4A136_group (UB*)[79]	d__Bacteria.p__Firmicutes.c__Clostridia.o__Lachnospirales.f__Lachnospiraceae.g__Lachnospiraceae_NK4A136_group.s__uncultured_bacterium
g__Succinivibrio (UB*)[80]	d__Bacteria.p__Proteobacteria.c__Gammaproteobacteria.o__Aeromonadales.f__Succinivibrionaceae.g__Succinivibrio.s__uncultured_bacterium
Adlercreutzia.[81]	d__Bacteria.p__Actinobacteriota.c__Coriobacteriia.o__Coriobacteriales.f__Eggerthellaceae.g__Adlercreutzia.__
Eggerthella_lenta[82]	d__Bacteria.p__Actinobacteriota.c__Coriobacteriia.o__Coriobacteriales.f__Eggerthellaceae.g__Eggerthella.s__Eggerthella_lenta
Eggerthella.[83]	d__Bacteria.p__Actinobacteriota.c__Coriobacteriia.o__Coriobacteriales.f__Eggerthellaceae.g__Eggerthella.__
Lactobacillus_rhamnosus[84]	d__Bacteria.p__Firmicutes.c__Bacilli.o__Lactobacillales.f__Lactobacillaceae.g__Lactobacillus.s__Lactobacillus_rhamnosus
Lactobacillus.[85]	d__Bacteria.p__Firmicutes.c__Bacilli.o__Lactobacillales.f__Lactobacillaceae.g__Lactobacillus.__
g__Muribaculaceae (UB*)[86]	d__Bacteria.p__Bacteroidota.c__Bacteroidia.o__Bacteroidales.f__Muribaculaceae.g__Muribaculaceae.s__uncultured_bacterium
g__Hungatella (UB*)[87]	d__Bacteria.p__Firmicutes.c__Clostridia.o__Lachnospirales.f__Lachnospiraceae.g__Hungatella.s__uncultured_bacterium
g__Dorea (UB*)[88]	d__Bacteria.p__Firmicutes.c__Clostridia.o__Lachnospirales.f__Lachnospiraceae.g__Dorea.s__uncultured_bacterium
Streptococcus.[89]	d__Bacteria.p__Firmicutes.c__Bacilli.o__Lactobacillales.f__Streptococcaceae.g__Streptococcus.__
g__Romboutsia (UB*)[90]	d__Bacteria.p__Firmicutes.c__Clostridia.o__Peptostreptococcales.Tissierellales.f__Peptostreptococcaceae.g__Romboutsia.s__uncultured_bacterium
g__Lactobacillus (UB*)[91]	d__Bacteria.p__Firmicutes.c__Bacilli.o__Lactobacillales.f__Lactobacillaceae.g__Lactobacillus.s__uncultured_bacterium
Anaerostipes.[92]	d__Bacteria.p__Firmicutes.c__Clostridia.o__Lachnospirales.f__Lachnospiraceae.g__Anaerostipes.__
Ruminococcaceae.[93]	d__Bacteria.p__Firmicutes.c__Clostridia.o__Oscillospirales.f__Ruminococcaceae.__.__
Gordonibacter.[94]	d__Bacteria.p__Actinobacteriota.c__Coriobacteriia.o__Coriobacteriales.f__Eggerthellaceae.g__Gordonibacter.__
Desulfovibrio.[95]	d__Bacteria.p__Desulfobacterota.c__Desulfovibrionia.o__Desulfovibrionales.f__Desulfovibrionaceae.g__Desulfovibrio.__
.Eubacterium._coprostanoligenes_group.[96]	d__Bacteria.p__Firmicutes.c__Clostridia.o__Oscillospirales.f__.Eubacterium._coprostanoligenes_group.g__.Eubacterium._coprostanoligenes_group.__
g__Lachnoclostridium (UB*)[97]	d__Bacteria.p__Firmicutes.c__Clostridia.o__Lachnospirales.f__Lachnospiraceae.g__Lachnoclostridium.s__uncultured_bacterium
uncultured.[98]	d__Bacteria.p__Proteobacteria.c__Alphaproteobacteria.o__Rhodospirillales.f__uncultured.g__uncultured.__
Ruminococcus.[99]	d__Bacteria.p__Firmicutes.c__Clostridia.o__Oscillospirales.f__Ruminococcaceae.g__Ruminococcus.__
g__uncultured (UB*)[100]	d__Bacteria.p__Firmicutes.c__Clostridia.o__Oscillospirales.f__Ruminococcaceae.g__uncultured.s__uncultured_bacterium
g__Butyricicoccus (UB*)[101]	d__Bacteria.p__Firmicutes.c__Clostridia.o__Oscillospirales.f__Butyricicoccaceae.g__Butyricicoccus.s__uncultured_bacterium
g__uncultured (UB*)[102]	d__Bacteria.p__Actinobacteriota.c__Coriobacteriia.o__Coriobacteriales.f__Eggerthellaceae.g__uncultured.s__uncultured_bacterium
g__Clostridium_sensu_stricto_1 (UB*)[103]	d__Bacteria.p__Firmicutes.c__Clostridia.o__Clostridiales.f__Clostridiaceae.g__Clostridium_sensu_stricto_1.s__uncultured_bacterium
g__.Eubacterium._siraeum_group (UB*)[104]	d__Bacteria.p__Firmicutes.c__Clostridia.o__Oscillospirales.f__Ruminococcaceae.g__.Eubacterium._siraeum_group.s__uncultured_bacterium
UBA1819.[105]	d__Bacteria.p__Firmicutes.c__Clostridia.o__Oscillospirales.f__Ruminococcaceae.g__UBA1819.__
g__Acidaminococcus (UB*)[106]	d__Bacteria.p__Firmicutes.c__Negativicutes.o__Acidaminococcales.f__Acidaminococcaceae.g__Acidaminococcus.s__uncultured_bacterium
g__Lachnospiraceae_UCG.008 (UB*)[107]	d__Bacteria.p__Firmicutes.c__Clostridia.o__Lachnospirales.f__Lachnospiraceae.g__Lachnospiraceae_UCG.008.s__uncultured_bacterium
Oscillospirales.[108]	d__Bacteria.p__Firmicutes.c__Clostridia.o__Oscillospirales.__.__.__
g__Haemophilus (UB*)[109]	d__Bacteria.p__Proteobacteria.c__Gammaproteobacteria.o__Pasteurellales.f__Pasteurellaceae.g__Haemophilus.s__uncultured_bacterium
g__RF39 (UB*)[110]	d__Bacteria.p__Firmicutes.c__Bacilli.o__RF39.f__RF39.g__RF39.s__uncultured_bacterium
g__Tyzzerella (UB*)[111]	d__Bacteria.p__Firmicutes.c__Clostridia.o__Lachnospirales.f__Lachnospiraceae.g__Tyzzerella.s__uncultured_bacterium
g__Colidextribacter (UB*)[112]	d__Bacteria.p__Firmicutes.c__Clostridia.o__Oscillospirales.f__Oscillospiraceae.g__Colidextribacter.s__uncultured_bacterium
g__CAG.352 (UB*)[113]	d__Bacteria.p__Firmicutes.c__Clostridia.o__Oscillospirales.f__Ruminococcaceae.g__CAG.352.s__uncultured_bacterium
g__Megamonas (UB*)[114]	d__Bacteria.p__Firmicutes.c__Negativicutes.o__Veillonellales.Selenomonadales.f__Selenomonadaceae.g__Megamonas.s__uncultured_bacterium
Pseudomonas.[115]	d__Bacteria.p__Proteobacteria.c__Gammaproteobacteria.o__Pseudomonadales.f__Pseudomonadaceae.g__Pseudomonas.__
g__Alistipes (UB*)[116]	d__Bacteria.p__Bacteroidota.c__Bacteroidia.o__Bacteroidales.f__Rikenellaceae.g__Alistipes.s__uncultured_bacterium
Holdemania.[117]	d__Bacteria.p__Firmicutes.c__Bacilli.o__Erysipelotrichales.f__Erysipelotrichaceae.g__Holdemania.__
g__.Ruminococcus._gnavus_group (UB*)[118]	d__Bacteria.p__Firmicutes.c__Clostridia.o__Lachnospirales.f__Lachnospiraceae.g__.Ruminococcus._gnavus_group.s__uncultured_bacterium
g__Frisingicoccus (UB*)[119]	d__Bacteria.p__Firmicutes.c__Clostridia.o__Lachnospirales.f__Lachnospiraceae.g__Frisingicoccus.s__uncultured_bacterium
DTU089.[120]	d__Bacteria.p__Firmicutes.c__Clostridia.o__Oscillospirales.f__Ruminococcaceae.g__DTU089.__
uncultured.[121]	d__Bacteria.p__Firmicutes.c__Clostridia.o__Lachnospirales.f__Lachnospiraceae.g__uncultured.__
Eggerthellaceae.[122]	d__Bacteria.p__Actinobacteriota.c__Coriobacteriia.o__Coriobacteriales.f__Eggerthellaceae.__.__
Flavonifractor_plautii[123]	d__Bacteria.p__Firmicutes.c__Clostridia.o__Oscillospirales.f__Oscillospiraceae.g__Flavonifractor.s__Flavonifractor_plautii
g__uncultured (UB*)[124]	d__Bacteria.p__Firmicutes.c__Clostridia.o__Christensenellales.f__Christensenellaceae.g__uncultured.s__uncultured_bacterium
g__Sellimonas (UB*)[125]	d__Bacteria.p__Firmicutes.c__Clostridia.o__Lachnospirales.f__Lachnospiraceae.g__Sellimonas.s__uncultured_bacterium
Enterobacter.[126]	d__Bacteria.p__Proteobacteria.c__Gammaproteobacteria.o__Enterobacterales.f__Enterobacteriaceae.g__Enterobacter.__
g__UCG.003 (UB*)[127]	d__Bacteria.p__Firmicutes.c__Clostridia.o__Oscillospirales.f__Oscillospiraceae.g__UCG.003.s__uncultured_bacterium
Escherichia.Shigella.[128]	d__Bacteria.p__Proteobacteria.c__Gammaproteobacteria.o__Enterobacterales.f__Enterobacteriaceae.g__Escherichia.Shigella.__
g__.Eubacterium._ruminantium_group (UB*)[129]	d__Bacteria.p__Firmicutes.c__Clostridia.o__Lachnospirales.f__Lachnospiraceae.g__.Eubacterium._ruminantium_group.s__uncultured_bacterium
Phascolarctobacterium.[130]	d__Bacteria.p__Firmicutes.c__Negativicutes.o__Acidaminococcales.f__Acidaminococcaceae.g__Phascolarctobacterium.__
Hungatella.[131]	d__Bacteria.p__Firmicutes.c__Clostridia.o__Lachnospirales.f__Lachnospiraceae.g__Hungatella.__
Erysipelotrichaceae_UCG.003.[132]	d__Bacteria.p__Firmicutes.c__Bacilli.o__Erysipelotrichales.f__Erysipelatoclostridiaceae.g__Erysipelotrichaceae_UCG.003.__
g__Slackia (UB*)[133]	d__Bacteria.p__Actinobacteriota.c__Coriobacteriia.o__Coriobacteriales.f__Eggerthellaceae.g__Slackia.s__uncultured_bacterium
.Ruminococcus._gnavus_group.[134]	d__Bacteria.p__Firmicutes.c__Clostridia.o__Lachnospirales.f__Lachnospiraceae.g__.Ruminococcus._gnavus_group.__
g__Bilophila (UB*)[135]	d__Bacteria.p__Desulfobacterota.c__Desulfovibrionia.o__Desulfovibrionales.f__Desulfovibrionaceae.g__Bilophila.s__uncultured_bacterium
.Eubacterium._eligens_group.[136]	d__Bacteria.p__Firmicutes.c__Clostridia.o__Lachnospirales.f__Lachnospiraceae.g__.Eubacterium._eligens_group.__
UCG.002.[137]	d__Bacteria.p__Firmicutes.c__Clostridia.o__Oscillospirales.f__Oscillospiraceae.g__UCG.002.__
g__Actinomyces (UB*)[138]	d__Bacteria.p__Actinobacteriota.c__Actinobacteria.o__Actinomycetales.f__Actinomycetaceae.g__Actinomyces.s__uncultured_bacterium
Dysgonomonas.[139]	d__Bacteria.p__Bacteroidota.c__Bacteroidia.o__Bacteroidales.f__Dysgonomonadaceae.g__Dysgonomonas.__
Bifidobacterium_longum[140]	d__Bacteria.p__Actinobacteriota.c__Actinobacteria.o__Bifidobacteriales.f__Bifidobacteriaceae.g__Bifidobacterium.s__Bifidobacterium_longum
g__Negativibacillus (UB*)[141]	d__Bacteria.p__Firmicutes.c__Clostridia.o__Oscillospirales.f__Ruminococcaceae.g__Negativibacillus.s__uncultured_bacterium
Lactobacillus_helveticus[142]	d__Bacteria.p__Firmicutes.c__Bacilli.o__Lactobacillales.f__Lactobacillaceae.g__Lactobacillus.s__Lactobacillus_helveticus
Solobacterium.[143]	d__Bacteria.p__Firmicutes.c__Bacilli.o__Erysipelotrichales.f__Erysipelotrichaceae.g__Solobacterium.__
Collinsella.[144]	d__Bacteria.p__Actinobacteriota.c__Coriobacteriia.o__Coriobacteriales.f__Coriobacteriaceae.g__Collinsella.__
g__Desulfovibrio (UB*)[145]	d__Bacteria.p__Desulfobacterota.c__Desulfovibrionia.o__Desulfovibrionales.f__Desulfovibrionaceae.g__Desulfovibrio.s__uncultured_bacterium
g__Parasutterella (UB*)[146]	d__Bacteria.p__Proteobacteria.c__Gammaproteobacteria.o__Burkholderiales.f__Sutterellaceae.g__Parasutterella.s__uncultured_bacterium
.Eubacterium._nodatum_group.[147]	d__Bacteria.p__Firmicutes.c__Clostridia.o__Peptostreptococcales.Tissierellales.f__Anaerovoracaceae.g__.Eubacterium._nodatum_group.__
uncultured_organism[148]	d__Bacteria.p__Firmicutes.c__Clostridia.o__Oscillospirales.f__Ruminococcaceae.g__Incertae_Sedis.s__uncultured_organism
Streptococcus_parasanguinis[149]	d__Bacteria.p__Firmicutes.c__Bacilli.o__Lactobacillales.f__Streptococcaceae.g__Streptococcus.s__Streptococcus_parasanguinis
Enterococcus.[150]	d__Bacteria.p__Firmicutes.c__Bacilli.o__Lactobacillales.f__Enterococcaceae.g__Enterococcus.__
uncultured_organism[151]	d__Bacteria.p__Firmicutes.c__Clostridia.o__Lachnospirales.f__Lachnospiraceae.g__uncultured.s__uncultured_organism
g__Oscillibacter (UB*)[152]	d__Bacteria.p__Firmicutes.c__Clostridia.o__Oscillospirales.f__Oscillospiraceae.g__Oscillibacter.s__uncultured_bacterium
g__Lachnospiraceae_UCG.001 (UB*)[153]	d__Bacteria.p__Firmicutes.c__Clostridia.o__Lachnospirales.f__Lachnospiraceae.g__Lachnospiraceae_UCG.001.s__uncultured_bacterium
Anaerotruncus.[154]	d__Bacteria.p__Firmicutes.c__Clostridia.o__Oscillospirales.f__Ruminococcaceae.g__Anaerotruncus.__
g__Terrisporobacter (UB*)[155]	d__Bacteria.p__Firmicutes.c__Clostridia.o__Peptostreptococcales.Tissierellales.f__Peptostreptococcaceae.g__Terrisporobacter.s__uncultured_bacterium
g__Prevotellaceae_UCG.001 (UB*)[156]	d__Bacteria.p__Bacteroidota.c__Bacteroidia.o__Bacteroidales.f__Prevotellaceae.g__Prevotellaceae_UCG.001.s__uncultured_bacterium
g__Paraprevotella (UB*)[157]	d__Bacteria.p__Bacteroidota.c__Bacteroidia.o__Bacteroidales.f__Prevotellaceae.g__Paraprevotella.s__uncultured_bacterium
g__uncultured (UB*)[158]	d__Bacteria.p__Proteobacteria.c__Alphaproteobacteria.o__Rhodospirillales.f__uncultured.g__uncultured.s__uncultured_bacterium
g__uncultured (UB*)[159]	d__Bacteria.p__Actinobacteriota.c__Coriobacteriia.o__Coriobacteriales.f__Coriobacteriales_Incertae_Sedis.g__uncultured.s__uncultured_bacterium
g__Sutterella (UB*)[160]	d__Bacteria.p__Proteobacteria.c__Gammaproteobacteria.o__Burkholderiales.f__Sutterellaceae.g__Sutterella.s__uncultured_bacterium
g__Intestinibacter (UB*)[161]	d__Bacteria.p__Firmicutes.c__Clostridia.o__Peptostreptococcales.Tissierellales.f__Peptostreptococcaceae.g__Intestinibacter.s__uncultured_bacterium
g__Lachnospiraceae_FCS020_group (UB*)[162]	d__Bacteria.p__Firmicutes.c__Clostridia.o__Lachnospirales.f__Lachnospiraceae.g__Lachnospiraceae_FCS020_group.s__uncultured_bacterium
uncultured_organism[163]	d__Bacteria.p__Firmicutes.c__Clostridia.o__Lachnospirales.f__Lachnospiraceae.g__Lachnoclostridium.s__uncultured_organism
Odoribacter.[164]	d__Bacteria.p__Bacteroidota.c__Bacteroidia.o__Bacteroidales.f__Marinifilaceae.g__Odoribacter.__
Lactococcus_lactis[165]	d__Bacteria.p__Firmicutes.c__Bacilli.o__Lactobacillales.f__Streptococcaceae.g__Lactococcus.s__Lactococcus_lactis
g__.Eubacterium._ventriosum_group (UB*)[166]	d__Bacteria.p__Firmicutes.c__Clostridia.o__Lachnospirales.f__Lachnospiraceae.g__.Eubacterium._ventriosum_group.s__uncultured_bacterium
uncultured_organism[167]	d__Bacteria.p__Firmicutes.c__Clostridia.o__Lachnospirales.f__Lachnospiraceae.g__Eisenbergiella.s__uncultured_organism
.Eubacterium._fissicatena_group.[168]	d__Bacteria.p__Firmicutes.c__Clostridia.o__Lachnospirales.f__Lachnospiraceae.g__.Eubacterium._fissicatena_group.__
g__Family_XIII_UCG.001 (UB*)[169]	d__Bacteria.p__Firmicutes.c__Clostridia.o__Peptostreptococcales.Tissierellales.f__Anaerovoracaceae.g__Family_XIII_UCG.001.s__uncultured_bacterium
uncultured_organism[170]	d__Bacteria.p__Firmicutes.c__Clostridia.o__Lachnospirales.f__Lachnospiraceae.g__Anaerostipes.s__uncultured_organism
Bifidobacterium_bifidum[171]	d__Bacteria.p__Actinobacteriota.c__Actinobacteria.o__Bifidobacteriales.f__Bifidobacteriaceae.g__Bifidobacterium.s__Bifidobacterium_bifidum
Slackia.[172]	d__Bacteria.p__Actinobacteriota.c__Coriobacteriia.o__Coriobacteriales.f__Eggerthellaceae.g__Slackia.__
Cloacibacillus.[173]	d__Bacteria.p__Synergistota.c__Synergistia.o__Synergistales.f__Synergistaceae.g__Cloacibacillus.__
g__Escherichia.Shigella (UB*)[174]	d__Bacteria.p__Proteobacteria.c__Gammaproteobacteria.o__Enterobacterales.f__Enterobacteriaceae.g__Escherichia.Shigella.s__uncultured_bacterium
Lachnospiraceae_UCG.004.[175]	d__Bacteria.p__Firmicutes.c__Clostridia.o__Lachnospirales.f__Lachnospiraceae.g__Lachnospiraceae_UCG.004.__
Klebsiella.[176]	d__Bacteria.p__Proteobacteria.c__Gammaproteobacteria.o__Enterobacterales.f__Enterobacteriaceae.g__Klebsiella.__
